111111111111111111111111111111
10000000000000000C100000000001
100000000000000011100000000001
100000000000000000000100000001
100000111111000000000100000001
100000100001000000000100000001
100000100001000000111100000001
100000111111000000000100000001
100000000000000000000100000001
1000000C0000000000000100000C01
100000000100111110000100000001
100000000000000000000111111C11
100000000000000000000100000001
10P00000000000000000010E000001
111111111111111111111111111111
