111111111111111111111111111111
1000000000000C0C01000000000001
100000000000111111000000000001
100000000000000000001111001111
100100111111000000001111001111
100100000001000000001110000111
1001000CCCC1000000111110000011
100100111111000000001100110001
100100000000000000001100110001
1001000C0000000000001100110001
1001111111001111100011CC000001
100000000000000000001111111011
100000000000000000001100000001
1111111001111111110011E00000C1
1P0000000000000000001111111111
111111111111111111111111111111
