111111111111111111111111111111
100000000000000000000C00000001
100000000000000000000C00000001
100000000C00000000000100000001
100000111111000D00000100000001
1000001000010000000C0100000001
1000001000010D0000111100000001
10000011111100000000010000D001
1000000000000000000001000D0D01
10000D0C00000C00D0000100D000D1
1000011111001111100001000D0D01
10000000000000000000010000D001
100000000000000000000100000001
10P000C000D00C000000010E000001
111111111111111111111111111111
