1111111111111111
10CCC00000000001
10CEC00000000001
10CCC00000000001
1000000000000001
1000000000101001
10000000C11011C1
1111111111101111
1P0000000C000001
1111111111111111
