1111111111111111
10CCC00000000001
10CEC00000000001
10CCC0000D000001
100000000000D001
1000000000101001
1000D000C11011C1
1111111111101111
1P0000000C000001
1111111111111111
