11111111111
11000000011
11EC1010C11
11111011111
11111P11111
11111111111
