111111111111111
10C000000C0E111
111110111111111
111110000001111
111111111100111
1C0000000000001
100000000000011
1000C00000C0011
1000000P0000011
111111111111111
