11111111111111
10000000000E01
10000C00100001
10000000000001
1000C00000C001
100P0000000001
11111111111111
